[Magma Tempest, Greater Chain, Dragon Breath, Corruption Blast, Sunshine, Sonic Wave, ]	expected primary dps =3218, secondary dps =1944
[Magma Tempest, Sunshine, Greater Chain, Corruption Blast, Dragon Breath, Sonic Wave, ]	expected primary dps =3383, secondary dps =1927
[Greater Chain, Magma Tempest, Dragon Breath, Sonic Wave, Corruption Blast, Sunshine, ]	expected primary dps =3420, secondary dps =1917
[Corruption Blast, Greater Chain, Dragon Breath, Magma Tempest, Sonic Wave, Sunshine, ]	expected primary dps =3139, secondary dps =1916
[Sunshine, Corruption Blast, Greater Chain, Dragon Breath, Magma Tempest, Sonic Wave, ]	expected primary dps =3148, secondary dps =1910
[Corruption Blast, Sunshine, Greater Chain, Magma Tempest, Dragon Breath, Sonic Wave, ]	expected primary dps =3333, secondary dps =1910
[Greater Chain, Dragon Breath, Magma Tempest, Corruption Blast, Sonic Wave, Sunshine, ]	expected primary dps =3212, secondary dps =1909
[Magma Tempest, Greater Chain, Dragon Breath, Corruption Blast, Sonic Wave, Sunshine, ]	expected primary dps =3137, secondary dps =1909
[Corruption Blast, Greater Chain, Dragon Breath, Magma Tempest, Sunshine, Sonic Wave, ]	expected primary dps =3177, secondary dps =1908
[Magma Tempest, Dragon Breath, Greater Chain, Corruption Blast, Sunshine, Sonic Wave, ]	expected primary dps =3328, secondary dps =1902
[Sunshine, Greater Chain, Corruption Blast, Dragon Breath, Sonic Wave, Magma Tempest, ]	expected primary dps =3396, secondary dps =1898
[Sunshine, Greater Chain, Dragon Breath, Corruption Blast, Magma Tempest, Sonic Wave, ]	expected primary dps =3114, secondary dps =1897
[Greater Chain, Sunshine, Dragon Breath, Corruption Blast, Magma Tempest, Sonic Wave, ]	expected primary dps =3119, secondary dps =1891
[Greater Chain, Corruption Blast, Dragon Breath, Sonic Wave, Magma Tempest, Sunshine, ]	expected primary dps =3408, secondary dps =1890
[Corruption Blast, Dragon Breath, Greater Chain, Magma Tempest, Sunshine, Sonic Wave, ]	expected primary dps =3287, secondary dps =1889
[Sunshine, Greater Chain, Dragon Breath, Magma Tempest, Corruption Blast, Sonic Wave, ]	expected primary dps =3091, secondary dps =1885
[Dragon Breath, Magma Tempest, Greater Chain, Sunshine, Corruption Blast, Sonic Wave, ]	expected primary dps =3292, secondary dps =1880
[Corruption Blast, Dragon Breath, Greater Chain, Magma Tempest, Sonic Wave, Sunshine, ]	expected primary dps =3249, secondary dps =1874
[Greater Chain, Dragon Breath, Corruption Blast, Magma Tempest, Sonic Wave, Sunshine, ]	expected primary dps =3147, secondary dps =1874
[Greater Chain, Sunshine, Dragon Breath, Magma Tempest, Corruption Blast, Sonic Wave, ]	expected primary dps =3086, secondary dps =1873
[Corruption Blast, Sunshine, Dragon Breath, Magma Tempest, Greater Chain, Sonic Wave, ]	expected primary dps =3322, secondary dps =1867
[Magma Tempest, Dragon Breath, Greater Chain, Sunshine, Corruption Blast, Sonic Wave, ]	expected primary dps =3282, secondary dps =1867
[Magma Tempest, Dragon Breath, Greater Chain, Corruption Blast, Sonic Wave, Sunshine, ]	expected primary dps =3247, secondary dps =1867
[Sunshine, Dragon Breath, Corruption Blast, Greater Chain, Sonic Wave, Magma Tempest, ]	expected primary dps =3398, secondary dps =1866
[Dragon Breath, Magma Tempest, Greater Chain, Sonic Wave, Corruption Blast, Sunshine, ]	expected primary dps =3330, secondary dps =1866
[Sunshine, Corruption Blast, Dragon Breath, Greater Chain, Magma Tempest, Sonic Wave, ]	expected primary dps =3253, secondary dps =1864
[Sunshine, Greater Chain, Magma Tempest, Dragon Breath, Sonic Wave, Corruption Blast, ]	expected primary dps =3319, secondary dps =1864
[Sunshine, Magma Tempest, Greater Chain, Dragon Breath, Corruption Blast, Sonic Wave, ]	expected primary dps =3079, secondary dps =1864
[Greater Chain, Magma Tempest, Dragon Breath, Sunshine, Corruption Blast, Sonic Wave, ]	expected primary dps =3304, secondary dps =1864
[Sunshine, Dragon Breath, Greater Chain, Corruption Blast, Magma Tempest, Sonic Wave, ]	expected primary dps =3223, secondary dps =1860
[Dragon Breath, Greater Chain, Magma Tempest, Corruption Blast, Sonic Wave, Sunshine, ]	expected primary dps =3314, secondary dps =1858
[Greater Chain, Sunshine, Corruption Blast, Sonic Wave, Dragon Breath, Magma Tempest, ]	expected primary dps =3399, secondary dps =1858
[Dragon Breath, Corruption Blast, Greater Chain, Sonic Wave, Magma Tempest, Sunshine, ]	expected primary dps =3408, secondary dps =1857
[Dragon Breath, Sunshine, Greater Chain, Corruption Blast, Magma Tempest, Sonic Wave, ]	expected primary dps =3224, secondary dps =1855
[Magma Tempest, Sunshine, Greater Chain, Dragon Breath, Corruption Blast, Sonic Wave, ]	expected primary dps =3325, secondary dps =1851
[Magma Tempest, Sunshine, Dragon Breath, Corruption Blast, Greater Chain, Sonic Wave, ]	expected primary dps =3267, secondary dps =1850
[Corruption Blast, Dragon Breath, Magma Tempest, Sunshine, Greater Chain, Sonic Wave, ]	expected primary dps =3254, secondary dps =1849
[Corruption Blast, Sunshine, Greater Chain, Dragon Breath, Magma Tempest, Sonic Wave, ]	expected primary dps =3298, secondary dps =1844
[Dragon Breath, Corruption Blast, Greater Chain, Sunshine, Magma Tempest, Sonic Wave, ]	expected primary dps =3233, secondary dps =1844
[Dragon Breath, Greater Chain, Magma Tempest, Sunshine, Corruption Blast, Sonic Wave, ]	expected primary dps =3335, secondary dps =1844
[Magma Tempest, Sunshine, Dragon Breath, Greater Chain, Corruption Blast, Sonic Wave, ]	expected primary dps =3327, secondary dps =1843
[Sunshine, Dragon Breath, Greater Chain, Magma Tempest, Corruption Blast, Sonic Wave, ]	expected primary dps =3200, secondary dps =1842
[Dragon Breath, Greater Chain, Magma Tempest, Corruption Blast, Sunshine, Sonic Wave, ]	expected primary dps =3324, secondary dps =1840
[Dragon Breath, Magma Tempest, Corruption Blast, Greater Chain, Sunshine, Sonic Wave, ]	expected primary dps =3338, secondary dps =1840
[Magma Tempest, Greater Chain, Dragon Breath, Sunshine, Corruption Blast, Sonic Wave, ]	expected primary dps =3148, secondary dps =1840
[Magma Tempest, Corruption Blast, Greater Chain, Sunshine, Dragon Breath, Sonic Wave, ]	expected primary dps =3324, secondary dps =1838
[Magma Tempest, Dragon Breath, Corruption Blast, Sunshine, Greater Chain, Sonic Wave, ]	expected primary dps =3230, secondary dps =1837
[Dragon Breath, Greater Chain, Sunshine, Corruption Blast, Magma Tempest, Sonic Wave, ]	expected primary dps =3250, secondary dps =1835
[Dragon Breath, Sunshine, Greater Chain, Magma Tempest, Corruption Blast, Sonic Wave, ]	expected primary dps =3191, secondary dps =1832
[Dragon Breath, Sunshine, Corruption Blast, Sonic Wave, Greater Chain, Magma Tempest, ]	expected primary dps =3371, secondary dps =1831
