[Magma Tempest, Dragon Breath, Deep Impact, Sunshine, Corruption Blast, Greater Chain, Wild Magic, Tsunami, Sonic Wave, Tuska's Wrath, ]	expected primary dps =1443, secondary dps =1317
[Magma Tempest, Dragon Breath, Deep Impact, Sunshine, Corruption Blast, Greater Chain, Tsunami, Wild Magic, Sonic Wave, Tuska's Wrath, ]	expected primary dps =1443, secondary dps =1317
[Magma Tempest, Dragon Breath, Deep Impact, Corruption Blast, Sunshine, Greater Chain, Wild Magic, Tsunami, Sonic Wave, Tuska's Wrath, ]	expected primary dps =1443, secondary dps =1317
[Magma Tempest, Dragon Breath, Deep Impact, Corruption Blast, Sunshine, Greater Chain, Tsunami, Wild Magic, Sonic Wave, Tuska's Wrath, ]	expected primary dps =1443, secondary dps =1317
[Magma Tempest, Dragon Breath, Deep Impact, Corruption Blast, Greater Chain, Sunshine, Wild Magic, Tsunami, Sonic Wave, Tuska's Wrath, ]	expected primary dps =1443, secondary dps =1317
[Magma Tempest, Dragon Breath, Deep Impact, Corruption Blast, Greater Chain, Sunshine, Tsunami, Wild Magic, Sonic Wave, Tuska's Wrath, ]	expected primary dps =1443, secondary dps =1317
[Greater Chain, Magma Tempest, Corruption Blast, Dragon Breath, Sunshine, Tuska's Wrath, Wild Magic, Tsunami, Deep Impact, Sonic Wave, ]	expected primary dps =1443, secondary dps =1315
[Greater Chain, Magma Tempest, Corruption Blast, Dragon Breath, Sunshine, Wild Magic, Tuska's Wrath, Tsunami, Deep Impact, Sonic Wave, ]	expected primary dps =1443, secondary dps =1315
[Magma Tempest, Corruption Blast, Dragon Breath, Sunshine, Tuska's Wrath, Greater Chain, Wild Magic, Tsunami, Deep Impact, Sonic Wave, ]	expected primary dps =1446, secondary dps =1315
[Corruption Blast, Magma Tempest, Dragon Breath, Sunshine, Tuska's Wrath, Greater Chain, Wild Magic, Tsunami, Deep Impact, Sonic Wave, ]	expected primary dps =1443, secondary dps =1313
[Magma Tempest, Corruption Blast, Dragon Breath, Greater Chain, Tuska's Wrath, Sunshine, Wild Magic, Tsunami, Deep Impact, Sonic Wave, ]	expected primary dps =1444, secondary dps =1313
[Corruption Blast, Magma Tempest, Dragon Breath, Greater Chain, Tuska's Wrath, Sunshine, Wild Magic, Tsunami, Deep Impact, Sonic Wave, ]	expected primary dps =1442, secondary dps =1310
[Magma Tempest, Corruption Blast, Dragon Breath, Greater Chain, Tuska's Wrath, Sunshine, Wild Magic, Deep Impact, Tsunami, Sonic Wave, ]	expected primary dps =1446, secondary dps =1310
[Magma Tempest, Corruption Blast, Dragon Breath, Greater Chain, Tuska's Wrath, Sunshine, Wild Magic, Tsunami, Sonic Wave, Deep Impact, ]	expected primary dps =1442, secondary dps =1310
[Magma Tempest, Tuska's Wrath, Dragon Breath, Sunshine, Corruption Blast, Greater Chain, Wild Magic, Tsunami, Deep Impact, Sonic Wave, ]	expected primary dps =1438, secondary dps =1310
[Corruption Blast, Greater Chain, Wild Magic, Tuska's Wrath, Dragon Breath, Magma Tempest, Sunshine, Deep Impact, Tsunami, Sonic Wave, ]	expected primary dps =1443, secondary dps =1309
[Greater Chain, Corruption Blast, Magma Tempest, Dragon Breath, Sunshine, Tuska's Wrath, Wild Magic, Tsunami, Deep Impact, Sonic Wave, ]	expected primary dps =1437, secondary dps =1309
[Greater Chain, Corruption Blast, Magma Tempest, Dragon Breath, Sunshine, Wild Magic, Tuska's Wrath, Tsunami, Deep Impact, Sonic Wave, ]	expected primary dps =1437, secondary dps =1309
[Greater Chain, Magma Tempest, Corruption Blast, Dragon Breath, Sunshine, Tuska's Wrath, Tsunami, Wild Magic, Deep Impact, Sonic Wave, ]	expected primary dps =1435, secondary dps =1309
[Greater Chain, Magma Tempest, Corruption Blast, Dragon Breath, Sunshine, Tsunami, Tuska's Wrath, Wild Magic, Deep Impact, Sonic Wave, ]	expected primary dps =1435, secondary dps =1309
[Greater Chain, Magma Tempest, Corruption Blast, Dragon Breath, Sunshine, Tsunami, Wild Magic, Tuska's Wrath, Deep Impact, Sonic Wave, ]	expected primary dps =1435, secondary dps =1309
[Greater Chain, Magma Tempest, Corruption Blast, Dragon Breath, Deep Impact, Sunshine, Tuska's Wrath, Wild Magic, Tsunami, Sonic Wave, ]	expected primary dps =1423, secondary dps =1309
[Greater Chain, Magma Tempest, Corruption Blast, Dragon Breath, Deep Impact, Sunshine, Tuska's Wrath, Tsunami, Wild Magic, Sonic Wave, ]	expected primary dps =1423, secondary dps =1309
[Greater Chain, Magma Tempest, Corruption Blast, Dragon Breath, Deep Impact, Tuska's Wrath, Sunshine, Wild Magic, Tsunami, Sonic Wave, ]	expected primary dps =1423, secondary dps =1309
[Greater Chain, Magma Tempest, Corruption Blast, Dragon Breath, Deep Impact, Tuska's Wrath, Sunshine, Tsunami, Wild Magic, Sonic Wave, ]	expected primary dps =1423, secondary dps =1309
[Magma Tempest, Corruption Blast, Greater Chain, Wild Magic, Tuska's Wrath, Dragon Breath, Sunshine, Deep Impact, Tsunami, Sonic Wave, ]	expected primary dps =1439, secondary dps =1309
[Magma Tempest, Corruption Blast, Greater Chain, Wild Magic, Tuska's Wrath, Dragon Breath, Sunshine, Tsunami, Sonic Wave, Deep Impact, ]	expected primary dps =1437, secondary dps =1309
[Magma Tempest, Corruption Blast, Greater Chain, Wild Magic, Tuska's Wrath, Dragon Breath, Sunshine, Tsunami, Deep Impact, Sonic Wave, ]	expected primary dps =1439, secondary dps =1309
[Corruption Blast, Dragon Breath, Magma Tempest, Greater Chain, Sunshine, Tsunami, Wild Magic, Deep Impact, Sonic Wave, Tuska's Wrath, ]	expected primary dps =1427, secondary dps =1308
[Magma Tempest, Corruption Blast, Dragon Breath, Sunshine, Tuska's Wrath, Greater Chain, Tsunami, Wild Magic, Deep Impact, Sonic Wave, ]	expected primary dps =1435, secondary dps =1308
[Magma Tempest, Corruption Blast, Dragon Breath, Greater Chain, Tuska's Wrath, Sunshine, Deep Impact, Wild Magic, Tsunami, Sonic Wave, ]	expected primary dps =1424, secondary dps =1308
[Magma Tempest, Corruption Blast, Dragon Breath, Greater Chain, Tuska's Wrath, Sunshine, Deep Impact, Tsunami, Wild Magic, Sonic Wave, ]	expected primary dps =1424, secondary dps =1308
[Magma Tempest, Corruption Blast, Dragon Breath, Greater Chain, Tuska's Wrath, Sunshine, Tsunami, Deep Impact, Wild Magic, Sonic Wave, ]	expected primary dps =1424, secondary dps =1308
[Magma Tempest, Corruption Blast, Dragon Breath, Deep Impact, Sunshine, Tuska's Wrath, Greater Chain, Wild Magic, Tsunami, Sonic Wave, ]	expected primary dps =1425, secondary dps =1308
[Magma Tempest, Corruption Blast, Dragon Breath, Deep Impact, Sunshine, Tuska's Wrath, Greater Chain, Tsunami, Wild Magic, Sonic Wave, ]	expected primary dps =1425, secondary dps =1308
[Magma Tempest, Corruption Blast, Dragon Breath, Deep Impact, Tuska's Wrath, Sunshine, Greater Chain, Wild Magic, Tsunami, Sonic Wave, ]	expected primary dps =1425, secondary dps =1308
[Magma Tempest, Corruption Blast, Dragon Breath, Deep Impact, Tuska's Wrath, Sunshine, Greater Chain, Tsunami, Wild Magic, Sonic Wave, ]	expected primary dps =1425, secondary dps =1308
[Magma Tempest, Corruption Blast, Dragon Breath, Deep Impact, Tuska's Wrath, Greater Chain, Sunshine, Wild Magic, Tsunami, Sonic Wave, ]	expected primary dps =1425, secondary dps =1308
[Magma Tempest, Corruption Blast, Dragon Breath, Deep Impact, Tuska's Wrath, Greater Chain, Sunshine, Tsunami, Wild Magic, Sonic Wave, ]	expected primary dps =1425, secondary dps =1308
[Magma Tempest, Tuska's Wrath, Dragon Breath, Greater Chain, Corruption Blast, Sunshine, Wild Magic, Tsunami, Deep Impact, Sonic Wave, ]	expected primary dps =1437, secondary dps =1308
[Magma Tempest, Wild Magic, Sunshine, Corruption Blast, Dragon Breath, Tsunami, Greater Chain, Deep Impact, Sonic Wave, Tuska's Wrath, ]	expected primary dps =1456, secondary dps =1308
[Magma Tempest, Wild Magic, Corruption Blast, Sunshine, Dragon Breath, Tsunami, Greater Chain, Deep Impact, Sonic Wave, Tuska's Wrath, ]	expected primary dps =1456, secondary dps =1308
[Magma Tempest, Wild Magic, Corruption Blast, Dragon Breath, Sunshine, Tsunami, Greater Chain, Deep Impact, Sonic Wave, Tuska's Wrath, ]	expected primary dps =1456, secondary dps =1308
[Corruption Blast, Dragon Breath, Magma Tempest, Sunshine, Greater Chain, Tsunami, Wild Magic, Deep Impact, Sonic Wave, Tuska's Wrath, ]	expected primary dps =1428, secondary dps =1307
[Magma Tempest, Corruption Blast, Dragon Breath, Sunshine, Tuska's Wrath, Greater Chain, Wild Magic, Sonic Wave, Tsunami, Deep Impact, ]	expected primary dps =1438, secondary dps =1307
[Magma Tempest, Corruption Blast, Dragon Breath, Sunshine, Tuska's Wrath, Greater Chain, Wild Magic, Deep Impact, Tsunami, Sonic Wave, ]	expected primary dps =1442, secondary dps =1307
[Magma Tempest, Corruption Blast, Dragon Breath, Sunshine, Tuska's Wrath, Greater Chain, Wild Magic, Tsunami, Sonic Wave, Deep Impact, ]	expected primary dps =1438, secondary dps =1307
[Magma Tempest, Corruption Blast, Dragon Breath, Greater Chain, Tuska's Wrath, Sunshine, Tsunami, Wild Magic, Deep Impact, Sonic Wave, ]	expected primary dps =1435, secondary dps =1307
[Tuska's Wrath, Magma Tempest, Dragon Breath, Sunshine, Corruption Blast, Greater Chain, Wild Magic, Tsunami, Deep Impact, Sonic Wave, ]	expected primary dps =1435, secondary dps =1307
[Magma Tempest, Dragon Breath, Greater Chain, Wild Magic, Sunshine, Corruption Blast, Tuska's Wrath, Tsunami, Sonic Wave, Deep Impact, ]	expected primary dps =1443, secondary dps =1306

start: 	2022/2/21 7:27
end:	2022/2/22 13:19

5 min simulation, 10 abilities
